1111111111111
100100C0000C1
1C00P11111001
100011000E001
1111111101111
