11111111
1E100001
10101001
101C1001
100010P1
11111111
