111111111111
10000C000001
111110101011
111000101001
110000100001
1P00001C10E1
111111111111