111111111
1E1000001
101010001
101C10001
100010P01
111111111
