1111
1E01
1001
1C01
1P01
1111
