1111
1E001
1001
1001
1C01
10P1
1111
